HYPO	PARAPHRASES	MINIMAL UNITS CORPUS
The principal is unhappy...we're cooked. 	The principal is unhappy...we're in trouble.	Well cooked vegetables can be pureed easily.
The availability of data is likely to lead to a veritable orgy of statistical analysis. 	The availability of data is likely to lead to a large amount of statistical analysis.	"Having been purified, the pilgrim would join a sacred orgy."
Love you to the moon and back. 	Love you so much.	The missions successfully went to the moon and back.
"Man, your compassion is greater than space."	"Man, your compassion is huge."	Spacetime is more complicated than space.
Marriage is the grave of love.	Marriage is the end of love.	I have gone to visit the grave of a friend.
I went into the shop and we cleared the shelves out. 	I went into the shop and we bought a lot of things.	"At the restaurant, they cleared the shelves out and put in some old tables."
He's as mad as a hippo with a hernia. 	He's very mad.	I've never heard of a hippo with a hernia.
You're making a mountain out of a molehill. 	You're exaggerating.	A mountain dominates the city.
"Speech is silver, but silence is golden. "	"Speech is good, but silence is better."	Silver objects are rarer than golden ones in the tombs.
No offence but she's out of the world dumb.	No offence but she's dumb.	Going to Mars was an out of the world experience.
Miss Trunchbull's lips stretched in a glacial smile.	Miss Trunchbull's lips stretched in a serious smile.	The monsoon in causing a fall in glacial temperatures.
We're going to turn this sow's ear into a silk purse.	We're going to turn this sow's ear into something more valuable.	Put these items into a little silk purse.
This one is valuable: you don't touch a hair of his head.	This one is valuable: you don't touch him.	A hair of his head began to grow again.
He has a watermelon instead of a belly. 	He has a big belly.	Watermelon is speckled with black seeds.
The argument with my bestfriend turned into a tempest in a teacup.	The argument with my bestfriend turned into a fight.	"The story begins with a tempest in a teacup, and sugar cubes transforming into cruise ships."
"You know, the world could end before I'd let something happen to you."	"You know, I'll take care of you."	The world could end if all insect species died.
We must fight with the force of a typhoon.	We must fight with great force.	We can use the force of a typhoon to generate wind power.
These people would follow you to the end of the earth. 	These people would follow you.	The end of the earth cannot be found.
Beauty draws with a single hair. 	Beauty draws very easily.	Each root is normally associated with a single hair.
You'll devour the book in a couple of days.  	You'll read the book in a couple of days.	Tuna devour small fish.
"He hurts everybody, he has a sharp knife instead of a tongue. "	"He hurts everybody, he has a sharp tongue."	You should use a sharp knife instead of a meat grinder.
Technology annihilates humanity.	Technology hurts humanity.	"As the army forwards, it annihilates the enemy."
I've been enjoying this tea for all my life.  	I have been enjoying this tea for a long time.	I have lived in the country all my life.
"This book is a masterpiece, it is priceless! "	"This book is a masterpiece, it is excellent!"	The hope they can restore is priceless.
Her hair is the same as Rapunzel. 	Her hair is very long.	"The princess was trapped in a tower, same as Rapunzel."
You have no conception of the quantity of miserable feeling that passes through me in a day. 	I have negative feelings in the day.	You have no conception of the chemical composition of oil.
He hiccuped endlessly.  	He hiccuped for a long time.	Waves endlessly tumble to shore.
My heart's bleeding right now. 	My heart's hurt right now.	First aid for a bleeding nose is to pinch the nostrils.
The professor destroyed me in front of the class. 	The professor humiliated me in front of the class.	The bridge was destroyed.
His nose resembles Pinocchio's nose when he lies.	His nose is very big.	This tree branch resembles Pinocchio's nose.
I feel like I'm going to burst. 	I feel excited.	The historic building is going to burst into flames.
"I have fever, I can't move. "	"I have fever, moving is difficult."	"Since my operation, I can't move."
New York is the promised land to him.	New York is right place for him.	Moses intended to go straight on into the promised land.
"Even thinking back, it feels like living a fairy tail."	"Even thinking back, it feels like living a wonderful situation."	Our teacher who was recounting a fairy tale.
My sisters mean more than air to me. 	My sisters mean a lot to me.	Propane vapor weighs more than air.
Moms are more powerful than the sea. 	Moms are so powerful.	"The sky is unforgiving for computation mistakes, more than the sea."
"Well, this travel's going to be the start of a new life for us. "	"Well, this travel's going to be a new opportunity for us."	"I witnessed the start of a new life, I am a dad now."
People say Massimo has phenomenal cooking powers.  	People say Massimo has excellent cooking powers.	Through a phenomenal occurrence in nature
You should sunbathe! You look white as a ghost!	You should sunbathe! You look pale!	The future is invisible as a ghost.
I did not suspect it would be so good: this book is a pit of wonders. 	I did not suspect it would be so good: this book is wonderful.	The sultan was hiding precious gems in a pit of wonders set in his garden.
His hand is as cold as an ice box.	His hand is very cold.	"I went to Canada and once left my phone in the open air. After some hours, it was cold as an ice box."
My stomach almost bust.	My stomach is very bloated.	Property companies continue to go bust.
Faith will move mountains. 	Faith is a strong motivator.	An earthquake can move mountains.
Her smoldering eyes still scorch my soul.	Her smoldering eyes still make me feel bad.	Wildfires can scorch the soil.
The massages at the spa are miraculous. 	The massages at the spa render very good results.	The film is about the miraculous healing of a sick child.
"No more food, I'm stuffed. "	"No more food, I'm satiated."	"Olives are available, either plain or stuffed with almonds."
That girl's eyes shine like stars. 	That girl's eyes are bright.	Venus seems to shine like stars.
I felt fireworks in my brain when I set foot in the candy shop. 	I felt very happy when I set foot in the candy shop.	I will watch fireworks in my hometown.
The princess' lips shame the red rose. 	The princess' lips are red.	Youth unemployment figures shame the government.
My bank account runs dry. 	My bank account is almost empty.	The river runs dry.
"That joke is so old, the last time I heard it I was riding on a dinosaur. "	"That joke is so old, the last time I heard it was many years ago."	This is the first crest to be found on the fossil of a dinosaur.
"Insolent boy, I'll slash you to ribbons! "	"Insolent boy, I'll hit you!"	The boy's uniform was slashed into ribbons.
I would give my life for a coffee. 	I really want a coffee.	I am ready to give my life to save my brother.
I'll tell you a tale of the boundless blue that is the ocean.	I'll tell you a tale of the immense blue that is the ocean.	There exists a boundless number of points within a space.
"After watching the movie, I wanted to put the villain through the wall into the next planet. "	"After watching the movie, I wanted to hurt the villain."	Landing into the next planet will be an exciting experience.
"The noise was so great, that it was heard in both the countries."	"The noise was so great, that it was heard in a long distance."	Deterioration in road safety was witnessed in both the countries.
That must be the angel music I hear. 	That is great music I hear.	One belief is that you can hear the angel music when you pass out.
The buyer has need of a hundred eyes. 	The buyer has to be careful.	A hundred eyes stare at him.
"We've been dealing with it for months, and months and months. "	We've been dealing with it for months.	We haven't talked for months.
"I would buy it, if it did not cost an arm and a leg! "	"I would buy it, if it did not cost that much!"	"With only an arm and a leg, she crawled across the deck."
Even a baby could pass that test! 	It is very easy to pass that test!	Even a baby could understand what is going on here.
And soon I'll be famous beyond belief.  	And soon I'll be very famous.	What Jesus did is beyond belief: he transformed water into wine.
Old Mr. Smith has been teaching here since the Stone Age. 	Old Mr. Smith has been teaching here for a very long time.	This site has been a settlement since the Stone Age.
"Set a beggar on horseback, and he'll ride to the devil.  "	"Set a beggar on horseback, and he will ride far."	The exorcist claimed he was able to talk to the Devil.
Nothing's impossible!  	Most things are possible!	Nothing is impossible in a child's imagination.
A day was twenty-four hours long but seemed longer. 	A day was really exhausting.	"The movie lasted one hour, but seemed longer."
She'll erupt when she finds out that her brother left.	She'll get furious when she finds out that her brother left.	Volcanoes erupt underwater.
Nobody can beat level six.  	It would be difficult to beat level six.	Nobody seems to have explained this to her.
Supernatural courage is needed when bringing a message to a hostile audience. 	A great courage is needed when bringing a message to a hostile audience.	Evolutionists gave a natural origin to human institutions instead of a supernatural origin.
Living with apprehensive parents is being trapped in a tower. 	Living with apprehensive parents is very limiting.	"Trapped in a tower, the princess spent her days drawing."
A man can have a belly you could house a commercial aircraft in.  	A man can have a very large belly.	Our warehouse could house a commercial aircraft.
We are traversing the vast desert of everyday life.   	We live by ourselves in everyday life.	We were traversing the vast desert of Isran.
Jason would rather lose an arm than lose face by pulling out.  	Jason would rather keep going than lose face by pulling out.	He may still lose an arm from that attack.
It was said that he had read so many books that his brain dried up.	It was said that he had read so many books that his brain stopped working properly.	Make sure all excess liquid dried up.
All these parties will break my bank.  	All these parties are expensive.	
Dust-like snowflakes began to fall.  	Tiny snowflakes began to fall.	Fungi are filled with dust-like spores.
"See, my dear, a pair of high heels is indispensable these days.  "	"See, my dear, a pair of high heels is important these days."	Iron is indispensable for photosynthesis.
The joke was just epic!  	The joke was very good.	Epic poems have been created throughout history.
"I'm sure the spider was about to leap off the wall, latch itself onto my leg and start gnawing me. "	"I am sure the spider was about to leap off the wall, latch onto my leg and bite me."	Terry saw some apes biting themselves and gnawing at the bars.
Not too far away is an empire of chicken farms.  	Not too far away is a large chicken farm business.	The foundations of the empire were beginning to weaken.
The girl is no one.	The girl is not relevant.	There was no one there but the family.
You could see she was scared to death.  	You could see she was very scared.	The judge was shot to death in the front seat.
I'll see him wriggle like a worm on a hook!  	I'll see him become very nervous!	A moth looks like a worm.
The style is the man.    	The style is important to how we see a man.	The price is the same for all cards.
One could swear that the contortionist had no bones.	The contortionist was flexible.	I had no bones in the jaw.
Being in debt makes my muscles itch.   	Being in debt makes me uncomfortable.	I want to scratch my skin off whenever my muscles itch.
Masses of garbage reached so high that it lifted the roof. 	Masses of garbage reached so high that it touched the roof.	The blast blew out windows and lifted the roof.
"You are not a fully-grown man, you are a clown. "	"You are not a fully-grown man, you are very silly."	So you are a clown who uses music.
This drink makes you grow wings.	This drink gives you an energy lift.	Caterpillars grow wings and become butterflies.
"Remember, Quasimodo they're gypsies. They'll steal us blind.   "	"Remember, Quasimodo they're gypsies. They'll steal from us."	He had a blind eye.
My lover's arms were made to hold me close.  	My lover's arms are good at holding me close.	Attempts were made to help improve the situation.
The taste is perfect.  	The taste is very good.	A perfect circle then forms on the surface.
The veteran proclaimed he had tree trucks for legs. 	The veteran proclaimed he had strong legs.	Tree trucks had to go twenty miles out of the way.
Being led around aimlessly felt like being a zombie.  	Being led around aimlessly felt dull.	"The main character in the book struggles to achieve a tender relationship, despite him being a zombie."
It's painful to see you eating pineapple pizza. It hurts my Italian heart.  	I don't like to see you eating pineapple pizza. It hurts my Italian heart.	My right arm became painful. It hurts my shoulder.
Books are food for avid readers.  	Books are important for avid readers.	Amphibians in the wild are food for other animals.
Many questions were fired at us.  	Many questions were asked to us.	Several missiles were fired at us.
His eyes were pure black. 	His eyes were very dark.	Pure black goes with everything.
"Wow, I'm dead from the neck up today.  "	"Wow, I'm not functioning as well as I usually do today."	The singer was found dead today.
I know this place like the back of my hand. 	I know this place very well.	Your baby is already hairy like the back of my hand.
He's a wrecking ball for the future of the Party. 	He could damage the future of the party.	The structures can be demolished with a wrecking ball.
I can see you've lost your mind. 	I can see you are not thinking straight.	You've lost your wallet.
It was unpleasant seeing her in those cheap shapeless clothes.  	It was unpleasant seeing her in those cheap shabby clothes.	Shapeless emotions began to well up inside her.
Daisy Buchanan is Gatsby's grail that he fails to possess. 	Daisy Buchanan is Gatsby's target that he fails to possess.	The ruler authorized a mission to search for the grail.
I depend on my green tea fix each morning!   	I enjoy my green tea fix each morning!	I depend on nicotine for emotional stability.
"You're so sweet, you give me diabetes.   "	You're very sweet.	All that sugar might give me diabetes one day.
His charisma magnetized us.     	His charisma captivated us.	They used a magnetized needle.
"When you get emotional, your brain sort of short-circuits.   "	"When you get emotional, your brain looses its normal thinking abilities."	The current sort of short-circuits through their body.
Parents' affection is cosmic.  	Parents' affection is special.	Meteorites seem to contain cosmic dust.
I can smell pizza from a mile away.  	I can smell pizza from a long distance.	The hotel was only half a mile away.
I don't work without coffee: it's my lifeblood.  	I do not work without coffee: it is my sustenance.	Roots hold the plant's lifeblood.
The resources are pitifully small.    	The resources are very small.	He starts bleeding and crying pitifully.
She had an ethereal glow about her.   	She had a graceful glow about her.	"In the ethereal world of dreams, we can understand our lives."
The title says it all.      	The title is very descriptive.	I need say no more: you say it all better.
The president said that the well-being of citizens is his North Star.  	The president said that the well-being of citizens is his guiding principle.	The compass needle points towards the North star.
Your judgement at this point is worth less than nothing.  	Your judgement at this point is worthless.	
The minister told the guests that the couple's friendship was sweeter than honey. 	The minister told the guests that the couple's friendship was very sweet.	Maple syrup is sweeter than honey to my mouth!
I swear you've doubled in size since I saw you last month.   	I swear you have grown since I saw you last month.	A village on the estuary has doubled in size since last year.
Weight training is ridiculously good for you.   	Weight training is very good for you.	You ridiculously disguised as a captain.
His studded jacket is drilling in his body. 	His studded jacket is tight on his body.	The bricklayers are drilling in the wrong place.
They go about together like Siamese twins.  	They go about together.	Two others surviving against the odds are the Siamese twins.
They were probably hoping to crucify me in front of the whole world.  	They were probably hoping to punish me in front of the people.	"They shouted ""Crucify him!"" with the whole world's sin upon his back."
Guess you've run out of thoughts.  	Guess you've not many thoughts.	You have run out of biscuits.
One winter was so cold that the snow turned blue.  	One winter was colder than normal.	"After the incident, her finger turned blue."
So much snow that it's like walking in the firmament.  	So much snow that it's like walking on a soft ground.	Some stars in the firmament have a name.
"To some, AI is taking the lid off Pandora's box.  "	"To some, AI is beginning to generate complicated problems."	
"She is only a puppet, acting on the directives of her friends.  "	"She is only a follower, acting on the directives of her friends."	She made a costume to match her puppet.
Many people say that my father is still a kid. 	Many people say that my father is still immature.	"Don't blame him, he's still a kid."
I've seen this movie at least eighty thousand times.   	I've seen this movie many times.	These products are tested at least eighty thousand times.
It's the end of the world.   	It's a difficult time.	"At the beginning of the century, people forecasted the end of the world."
It is a truth universally acknowledged that a single man in possession of a fortune must be in want of a wife.	It is a truth widely acknowledged that a single man in possession of a fortune must be in want of a wife.	It is a truth universally acknowledged that crying is a sign of sadness.
Christmas will never come.  	Christmas will take a long time to come.	I could never rise so high.
She ran the whole gamut of emotions.    	She felt a number of emotions.	The exhibition runs the whole gamut of artistic styles.
He used to teach there and used to get harassed by all the pupils. 	He used to teach there and was bothered by all the pupils.	The victims are going to be harassed by the media.
That lawyer's words are bullets.	That lawyer's words are really harsh.	Sentries were given some bullets.
The taste of Kellogg's Frosted Flakes brings out the tiger in you. 	The taste of Kellogg's Frosted Flakes brings out your wildness.	The tiger paid them a visit.
Art is my stairway to heaven.   	Art is my peace of mind.	The priest said that compassion is a stairway to heaven.
No other friendship could be so strong.  	This is a very strong friendship.	No other jurisdiction has been established yet.
It drives me crazy when you only drink half of the soda.   	It annoys me when you only drink half of the soda.	Drugs drive me crazy.
"And there, before you, is barbeque perfection.     "	"And there, before you, is great barbeque."	Classical statues represent an ideal of perfection.
"Come on, I'm a vault of secrecy.     "	"Come on, I can keep secrets."	The vault of the ceiling was painted in yellow.
Seeing my bestfriend again would mean the world to me.    	Seeing my best friend again would mean a lot to me.	So many languages are spoken in the world.
After workout I feel I could lift a sumo wrestler.    	After workout I feel very strong.	This robot can lift a sumo wrestler.
We used to be as little independent as a flock of sheep.  	We used to have very little independence.	They bought the whole flock of sheep.
His mother is very apprehensive and keeps him in a bubble. 	His mother is very apprehensive and is very protective of him.	Many colors reflected in a bubble of foam.
That man corrupts whatsoever he touches.  	That man corrupts almost anything he has contact with.	That man accomplishes whatsoever he promises.
These flowers are absurdly awesome!  	These flowers are really awesome!	These economic strategies seem absurdly short-term.
And it is a tiny mouthful of heaven.   	And it tastes very good.	Many Christians are not focusing on heaven.
I love you with so much of my heart that none is left to protest. 	I love you with all my heart.	I remove all vegetation until none is left to sprout up later.
Over my dead body are you meeting with them.   	I will make it difficult for you to meet him.	Having some grass over my dead body sounds good.
This policy will plunge the country into a chaos. 	This policy will be a problematic one for the country.	The young ladies plunge into the pool.
My hair is poker-straight.   	My hair is very straight.	"In this geometric pattern, the lines are poker straight."
Your body is a wonderland.  	Your body is beautiful.	Carrol invented a wonderland with different logical rules.
"Sometimes, ignorance is bliss.  "	"Sometimes, ignorance is good."	Fulfillment is bliss.
I felt an explosion of flavor in my mouth.   	I tasted a very strong flavour.	The barricade dissolved in an explosion of smoke.
Your speech evokes a thousand sympathies.  	Your speech evokes many sympathies.	My mom earns a thousand dollars a month.
This restaurant sums up the neighbour in all its hipster glory!  	This restaurant sums up the neighborhood which is home to many hipsters!	Peter won glory on the field of battle.
"This blog is my harem, where my innermost secrets are shared. "	"This blog is my personal place, where my innermost secrets are shared."	The male can maintain a distribution of grooming up to a harem size of five females.
He's a monster. 	He's a terrible person.	"In some stories, Cerberus is a three-headed monster."
"It's so dark, a bat couldn't see in this room. "	It's very dark in the room.	"A bat couln't see the pole, so he flew away."
They were laughing to death.  	They were laughing hard.	Her father was sentenced to death.
"You stepped on a land mine, boy. "	"You did something dangerous, boy."	A land mine fell near shifting the two roads.
Daisy was an unattainable woman.   	Daisy was hard to get.	You set unattainable goals.
These are the proofs of the invincible smartness of the human race. 	These are proof of how smart the human race is.	"Had the Romans used our advanced weapons, they would have appeared invincible."
"When everyone went home for holidays, the campus became a ghost town."	"When everyone went home for holidays, the campus became deserted."	"When the last resident left, Masten became a ghost town."
You're being stalked by an emotional vampire.  	You're being stalked by a person who drains your emotions.	Villagers live in terror that they would be bitten by a vampire.
It'd take a miracle to get me into the army. 	It's tough for me to get into the army.	Old religious believe a miracle has happened.
It's time to stop living like a dead man. 	It's time to stop living in such a passive manner.	The glasses are cold like a dead man.
I lost my sense of humor in the before Christ to be precise.	I lost my sense of humor a long time ago.	The lost prince from India began his reign in the before Christ.
Be silent as a ninja. 	Be very silent.	A Ninja complied with no code of honour in combat situations.
"Move, there's no time. "	"Move, we have little time."	"Move, there's no time to explain everything now."
"You've made me the happiest man alive, Rita.   "	"You've made me very happy, Rita."	"If I were the happiest man alive, I'd tell you."
I just got hit by an avalanche of cramps.  	I just got hit by a lot of cramps.	Skiers are about to be hit by an avalanche.
He could swear he saw a wisp of smoke coming out of her ears.   	He saw how angry she was.	
With a word she can get what she came for.  	She can easily get what she came for.	There are differences that they can see but cannot label with a word.
I swear he'd rather die of starvation than even take a whiff of it!  	I swear he'd not take a whiff of it!	People continue to die of starvation.
"That artist is a wordless person, she rarely speaks. "	"That artist is a quiet person, she rarely speaks."	People often make wordless sounds to convey messages.
"Forget knocking it out of the park, Frank can knock a baseball off the continent.  "	"Forget knocking it out of the park, Frank can knock a baseball to a much larger distance."	Frank is ready to fly off the continent.
We must obey my mother's whims! We bow to her power!  	We must obey my mother's whims! We respect her power!	We had to bow to the prince.
This is a must buy! 	This is a very good deal!	"To play the online game, you must buy a license."
"The town I grew up in is so isolated that rock, paper, scissors is considered a high tech game.  "	The town I grew up in was isolated and behind the time.	Pokémon Go is considered a high tech game.
He drank a tanker of milk as if he was a drain. 	He drank a tanker of milk very quickly.	A diesel tanker fell into a drain.
This musician is the god of guitar.   	This musician is an expert at playing guitar.	He didn't like the people or the god of their cult.
I do not breathe without you.    	I do not live well without you.	Those who have severe sleep apnea do not breathe without a mask.
Better be out of the world than out of the fashion.  	Being out of fashion is very bad.	Children were kept out of the world of adult entertainment.
You don't ever listen to me.  	You don't listen to me.	"Please, don't ever harm yourself."
I thought we had a deal but you stabbed me in the back. 	I thought we had a deal but you betrayed me.	Someone stabbed me in the back but missed my heart.
Fabulous new haircut!  	I like your new haircut!	The writer created also another fabulous heroine in the book.
His bark breaks the sound barrier.  	His bark is very loud.	This subsonic airliner breaks the sound barrier.
I broke my ribs laughing.  	I felt my ribs hurt while laughing.	I broke my ribs riding my bike.
My tongue is a piece of sandpaper.  	My tongue is really rough.	Get a piece of sandpaper and rub it across the section of wood.
"And your father and I worked on those plans together, for months and months and months.  "	And your father and I worked on those plans together for a long time.	I've been exercising for lots of months.
He's light like a feather.  	He's light.	It is purple and green like the feather of a peacock.
"I'm quite imperturbable, only UFO can rock me.  "	"I'm quite imperturbable, it's very tough to rock me."	"Of the typical paranormal entities, only UFO are associated with machines."
"When my dog waves, his tail it causes hurricanes."	When my dog waves his tail rotates very fast.	The energy absorbed by the atmosphere causes hurricanes.
The flower of poetry will spring up toward God.  	The poetry will spring up magnificent.	The priest pointed up towards God.
We picked up a bottle once on a trip and were blown away!   	We picked up a bottle once on a trip and were surprised.	Small mammal bone is blown away by wind.
It is unthinkable to love and be wise.  	It is very difficult to love and be wise.	It is unthinkable that a child can solve differential equation.
"Given its advanced technologies, this is more of a spacecraft than a regular car."	"Given its advanced technologies, this car is more a sophisticated piece of machinery than a regular car."	The spacecraft did not reach its intended orbit.
People hang on your every word.  	People really listen to what you say.	Colorful paintings hang on every wall of my bedroom.
He eats a mountain of junk food. 	He eats a lot of junk food.	He emerged upon a mountain top in the clean air.
Haven't seen you in ages.    	Haven't seen you for a long time.	Crystals took ages to form.
I'd love to hang out eight days a week.   	I'd love to hang out every day.	First relief arrives after eight days.
It turns out Crumpet Manor had left Lily into a comatose state of relaxation. 	It turns out Crumpet Manor had left Lily into an intense state of relaxation.	The patient may still be irreversibly comatose.
My bedroom is my sanctuary.   	My bedroom is my private space.	Commercial netting was prohibited within the sanctuary.
I can conquer the world with you by my side.  	I can achieve great things with you by my side.	The Persian king Xerxes wanted to conquer the world.
Imagination is the queen of truth. 	Imagination leads to the truth.	People welcomed the Queen of Denmark.
"Your mom is so fat, I could slap her thigh and ride the wave!  "	Your mom is very fat!	I could ride the wave of popularity.
You can tell the judge how you made it vanish into thin air.  	You can tell the judge how you made it disappear.	"In one night, snow vanished into thin air."
"Starting from today, I'm a brand new person.  "	"Starting from today, I'm acting in a new way."	I just bought a brand new phone.
I would give my possessions for a pot of ale.  	I would really like a pot of ale.	I want to give my possessions to charity.
He walked down the road to nowhere.   	He walked down the road without any destination.	We were directed to nowhere in particular.
"I'm dying of hunger, I would eat a horse.   "	"I am hungry, I could eat a big meal."	"He, who was dying of asphyxiation, gave one final glance at his horse."
"I am sitting here, throned in blue sky like a sphinx.  "	I am sitting here with pride.	"The emperor's statue is here, throned in blue sky like a sphinx.  "
Travel broadens your brain.   	Travel increases your knowledge.	He broadens his influence by traveling to different cities.
Idleness is the root of evil.  	Idleness causes bad behavior.	Human capacity to invent meaning objects is the root of culture.
Finding the piece of paper in this chunk of documents is like looking for a needle in a haystack. 	Finding the piece of paper in this chunk of documents is nearly impossible.	He actually found a needle in a haystack...how ironic!
No one follows the rules in this office. It's a jungle.  	No one follows the rules in this office. There is no discipline.	He caught some virus from a jungle.
"Two years ago, I catapulted myself into the fashion world.   "	"Two years ago, I entered into the fashion world."	Stones were catapulted against the wall of the city.
Why did you beat him to a pulp?   	Why did you beat him so badly?	Mash the avocado to a pulp.
That old soldier is ready for another battle. He's made of iron. 	That old soldier is ready for another battle. He's tough.	The gate of the school is made of iron.
I worked myself to the bone. 	I worked very hard.	The doctor checked the ankle for an injury to the bone.
It's a no brainer. 	It's obvious.	Breathing is a no brainer exercise.
The pictures prove that the poor country has turned into hell.  	The pictures prove that the poor country is in a very bad situation.	Orpheus descended into hell to rescue Eurydice.
A roaring deluge of applauses followed the performance.   	Loud applause followed the performance.	We heard the roaring deluge of the river.
I was dazed by the elegance of the B&B.      	I was surprised by the elegance of the B&B.	"The gang left him dazed, bleeding."
"If this character was a real person, I'd break every bone in his body.  "	"If this character was a real person, I'd hurt him."	He managed to break every bone in his middle finger.
He's a giant with the brain of a chicken.   	He's a giant but is not intelligent.	The brain of a chicken is small.
Living with you is a rollercoaster but it's worth the thrill. 	Living with you has its ups and downs but it's worth the thrill.	I'd been yo-yoing up and down a rollercoaster.
"When your mother saw you, she was about to pass out from excitement.   "	"When your mother saw you, she was so very excited."	She felt as if she would pass out.
"My job is so boring, I want to die.   "	"My job is so boring, I don't want to do it."	Many terminally ill people want to die.
Too much work makes me feel demolished.   	Too much work makes me feel tired.	The steps at the front entrance were demolished
My paperworks piled up to the ceiling.   	My paperworks piled up high.	A gecko climbed up to the ceiling.
His shout could split rocks.     	His shout was very loud.	They learnt that explosives could split rocks.
"Trust him, he's more faithful than the rising sun.   "	"Trust him, he's faithful."	He woke up earlier than the rising sun.
Democrats and Republicans will agree on a tax reform bill when pigs will have wings! 	Democrats and Republicans will not agree on a tax reform bill!	"If pigs will have wings, I will know I have gone crazy."
"She has so many watches, she'd need eight arms to wear them all."	"She has so many watches, it's not possible to wear them all."	She'd need eight arms to mix all that dough at the same time.
Completing the puzzle took me decades.  	Completing the puzzle took me a long time.	The economic system of the last few decades has failed.
I am tormented day and night.    	I am tormented often.	The route has services day and night.
I was mortally sorry.     	I was deeply sorry.	The whales were shot and mortally wounded.
That idea is eating away at him.  	That idea makes him feel very worried.	Rust is eating away at the steel.
"As he grew, Victor became a shining star in a family of achievers.   "	"As he grew, Victor became the best amongst the family of high achievers."	The shining star over there seems to be moving.
Give a man rope enough and he will hang himself.  	Give a man rope enough and he will do very foolish things.	"The suicidal will prove his family is wrong, or he will hang himself."
Your indifference is tearing me apart.   	Your indifference is upsetting me.	That shark could be tearing me apart right now.
You hear that noise? It's ear-piercing.   	You hear that noise? It's very loud.	The alarm emits an ear-piercing a hundred fifteen decibel screech.
The ancient castle was so big that it took a week to walk from one end to the other. 	The ancient castle was so big that it took a lot of time to walk from one end to the other.	It took a week to walk from one end of the region to the other.
Your words are poison.  	Your words are very damaging.	Traces of poison were found in the bottle.
Sarah is completely lacking any sense of humor.  	Sarah does not have a good sense of humor.	The movie is completely lacking a sympathetic female presence.
Swamps of people are coming to my birthday party. 	Lots of people are coming to my birthday party.	The swamps were drained.
The blood flowing from the boy's tooth covered the tiled floor.  	The blood flowing from the boy's tooth dropped on the tiled floor.	A thin carpet covered the tile floor.
It seems to have been raining for fourty days and fourty nights. 	It seems to have been raining for a long time.	The Hebrews had traveled for fourty days and fourty nights.
The flap of skin opened like a cupboard door.      	The flap of skin opened wide.	She opened the cupboard door.
Your predictions were right. You have a third eye.  	Your predictions were right. You have great intuition.	The god Shiva uses a third eye to see beyond the apparent.
They were in a trance when arguing with that manipulator.  	They were in a daze when arguing with that manipulator.	They put the subject under trance before attempting any experimentation.
Those criminals are feasting on violence.     	Those criminals thrive on acts of violence.	The couple is feasting on a romantic dinner.
My evening jog with Bill turned into a marathon.   	My evening jog with Bill turned into a long run.	He once ran a marathon for training.
The global crisis has seen prices skyrocket over the past week. 	The global crisis has seen prices rise over the past week.	A meteor could skyrocket in the atmosphere.
The new king'll be all-time adored.   	The new king'll be adored.	It is an all-time truth that after life comes death.
There are cascades of clothes in my wardrobe!    	There are large amounts of clothes in my wardrobe!	On the way up the hill there are hidden cascades.
You will give a good first impression without a doubt.  	You will very likely give a good first impression.	I am without a doubt about the sort of assignment I have been presented with.
This is the single most important advice of your life.    	This is the really important advice of your life.	This is the single most expensive cake in the city.
Hyperbole is the greatest thing in the history of the universe.   	Hyperbole is a great thing.	Big Bang is described as the greatest explosion in the history of the universe.
The Eagle soars in the summit of the azure.     	The Eagle soars high in the sky.	"After the levelling, the summit of the hill dropped by ten metres."
"As a father, in this moment, there's just pain in my heart.  "	"As a father, in this moment, I am overwhelmed by pain."	I feel a pain in my abdomen.
Bring these vermin to the Palace of Justice.  	Bring these bad people to the Palace of Justice.	The beds were horrid filthy and full of vermin.
"Social security, health, welfare and education systems are being laid on a Procrustean bed."	"Social security, health, welfare and education systems are being held to a rigid standard."	Greek travelers were tortured on a Procrustean bed.
The secretary is a boot licking lapdog.   	The secretary is very servile.	I found the collar of the lap dog.
My dog can run faster than a thunderbolt.  	My dog can run very fast.	Sheet lightning is a brightening of the clouds rather than a thunderbolt striking the ground.
Doesn't change the fact that we're up to our necks in muck.  	Doesn't change the fact that we are in deep trouble.	We wanted to be buried up to our necks in sand.
He orders his family not to forget that he is the king of his house.   	He told his family not to forget that he is the head of his house.	Edward was the king of England.
"If Sylvia flirted with Johnny, Steve threatened to beat the living tar out of her.  "	"If Sylvia flirted with Johnny, Steve threatened to beat her."	
She was worn to a shadow after months of nursing her sick husband.  	She was weak after months of nursing her sick husband.	The image is similar to a shadow cast on the ground.
"I heard you possess eagle vision, Mister.  "	"I heard you possess good vision, Mister."	Eagle vision allows to spot prey easily.
I'm on a whisky diet. I've lost three days already.	"Because I drank so much whiskey, I do not remember the last three days."	The risk of data being lost must decrease.
"Don't touch a woman, not even with a flower. "	"Don't touch a woman, not even lightly."	"She did not decorate the garden, not even with a flower."
I thought I'd found sugar-free chocolate nirvana at first taste. 	I thought I'd found an amazing sugar-free chocolate at first taste.	One Buddhist priest claimed he went to nirvana.
It'll just - bam! - hit me like lightning. 	It'll just - bam! - hit me hard.	"This attack is like lightning, it never strikes twice in the same place."
This year the new fashion trends spread like wildfire.   	This year the new fashion trends spread quickly.	The virus spread like wildfire.
She can't see but darkness: she's desperate.    	She feels she is in the darkness: she's desperate.	She can't see anything since the accident impaired her view.
Seeing you again - my life seems to stop there. 	Seeing you again - my life is changed irrevocably by this.	I'll stay here to stop you running away.
This new computer program is all Greek to me. 	His new computer program is very difficult for me to understand.	Wine selection is all Greek.
The boy is an Adonis...and he knows it.  	The boy is handsome...and he knows it.	Apollo and Adonis are tributes to beauty.
I wouldn't miss the party for anything in the world. 	I don't want to miss the party.	My aunt does not love the world or anything in the world.
"At this price, it's a steal!      "	"At this price, it's a very good deal!"	A steal must be prevented.
I wear my favourite t-shirt day in day out.   	I wear my favourite t-shirt repeatedly.	I use my voice day in day out.
"She stood frozen, searching for him.    "	"She stood still, searching for him."	Frozen meals may sound the answer to a quick meal.
My oral exam was very quick. I was done seconds after entering the classroom. 	My oral exam was very quick. I was done soon after entering the classroom.	"Seconds after the sound, a consonant appears on the screen."
The reputation of this pizza's hanging by a thread.  	The reputation of this pizza is at risk.	A needle was hanging by a thread.
"A friend of mine brought the chips into work with the claim ""these will change your life"". "	"A friend of mine brought the chips into work with the claim ""these are excellent""."	"Unfortunately,  these surgeries will change your life."
I'm begging! Give me the last piece of the cake.	I'm requesting! Give me the last piece of the cake.	"You'll end up on the street, begging for some money."
The water in the sea is almost boiling.   	The water in the sea is really hot.	Almost boiling hot water poured out of the taps.
Life goes in a heartbeat.     	Life goes in a little bit of time.	The sound of a heartbeat helps you relax in stressful situations.
Music is my daily drug.     	Music is important to me.	I have an excuse to take my daily drug.
Fools rush in where angels fear to tread.  	Fools rush in where experienced people would not.	Angels fear to tread in the evil places of life.
The sins of the people would weight so heavy upon the land that the whole town would collapse.  	The sins of the people are very severe.	The cans weight so heavy that the whole shelves would collapse.
The player is undeniably talented. 	The player is very talented.	"Reports of the stakes vary, but the odds were undeniably high."
She met my dad and then got whizzed off to so many different countries.  	She met my dad and then got taken quickly off to so many different countries.	A mass of footage whizzed across the screens.
"Oh, you are soaked to the bone, monsieur.   "	"Oh, you are very wet, monsieur."	"Marinate the chicken for days, until it is soaked to the bone."
We were getting to be like two goldfish in a bowl with no way out.  	We were getting trapped with no way out.	There were two goldfish in a bowl.
"Oh, my mother, if you cough somewhere in Siberia she'll hear you.   "	My mother has good hearing.	She'll hear you crying.
"Intellectually speaking, this city is almost as sterile as the Sahara Desert.  "	"Intellectually speaking, this city is very sterile."	"One day, the city was as hot as the Sahara Desert."
She has a fairy aura.  	She has a nice sense about her.	She red many fairy adventures.
A man without purpose is an empty individual.    	A man without a purpose is an unfulfilled individual.	I see an empty seat at the briefing table.
He is a good dog who goes to church.    	He is a good faithful man who goes to church.	Here is the dog who goes to church with his owner.
This spray will fill your days with the freshness of the ocean breeze.  	This spray has the odour of freshness of the ocean breeze.	Fill your wardrobe with the latest peasant shirts.
For dinner he would eat a silo full of grain.  	For dinner he would eat a lot of grain.	Falling into a silo full of grain can be a problem.
"The temperature was so low, I saw polar bears wearing jackets.  "	The temperature was low.	Polar bears can live healthily at a low temperature.
Bikers coming from behind you are a calamity on the roads.  	Bikers coming from behind you are a danger on the roads.	The first calamity was a disastrous trade war.
"His teeth would uncover, and shine savage like the furnaces.  "	"His teeth would uncover, and shine very bright."	The bonfires shine savage like furnaces.
Taking my eyes off her is absurd.   	I don't want to stop looking at her.	Supporting the flatness of Earth is absurd.
"I only step on your toe, don't make a federal case out of it.   "	"I only step on your toe, don't make a big deal out of it."	The federal case was due to be decided by a jury.
Jack Marshall wouldn't hurt a fly. 	Jack Marshall wouldn't hurt anyone.	Only a fly was caught in the chamber with him.
An idle brain is the devil's workshop.  	An idle brain is the place where evil thoughts arise.	
Ice-cream saves human beings from boredom.   	Ice-cream stops you from feeling bored.	A pet dog saved his owner from a knife attack.
You are but unreasoning apes.     	You are very unreasoning persons.	Humans and apes have a common ancestor.
He has a whole room filled with cash.   	He has a lot of cash.	Scrooge McDuck had a whole room filled with cash.
I'm a hundred percent American.    	I am truly American.	T-Shirts are a hundred percent cotton.
"No matter what anybody says, you'll always be a prince to me.  "	No matter what anybody says you will always be important to me.	The boy uses his wishes to become a prince.
"Of the two brothers, the oldest was unquestionably the smartest. "	"Of the two brothers, the oldest was the smartest."	The property unquestionably belongs to the citizens.
Ours is the world's favourite airline.   	Ours is a favorite airline of many people in the world.	English is the world's international language.
Marta is pathologically unpunctual to her appointments.   	Marta is late to her appointments.	The five cases classified pathologically.
Stop bothering him: you're playing with fire.    	Stop bothering him: you're inviting trouble.	Playing with fire will get her burned.
It took him about an hour to comb his hair.    	It took him a fair bit of time to comb his hair.	Dinner will be ready in about an hour.
College students eat crap.        	College students eat unhealthy food.	The amount of crap that adorns my pavement is enormous.
Life is rushing by like a river in flood.    	Life is rushing by very quickly.	You should never cross a river in flood.
His nose became so long that he could not even turn around.  	His nose became so long that it troubled him.	A Puma was kept in a cage so small he could not even turn around.
The old driver arrived not a second too soon.  	The old driver arrived on time.	The spacecraft was launched not a second too soon.
It must be a dream! 	It is very hard to believe!	"I could fly and become invisible, so I realized it must be a dream!"
He has as many debts as a dog has fleas. 	He has many debts.	My friend's dog has fleas.
His piano playing is enough to make Beethoven turn in his grave. 	His piano playing is very bad.	
That chocolate melts in your mouth like a single snowflake in the palm of your hand.    	That chocolate melts in your mouth smoothly.	The touch of this mosquito is like a single snowflake in the palm of your hand.
At no time does a watched pot boil.  	A watched pot seems to take a long time to boil.	At no time did we throw the towel in.
The work of the farm seemed to rest entirely on this horse's mighty shoulders.  	The work of the farm seemed to rest on this horse's mighty shoulders.	The photo fits entirely in one page.
Shopping drained me today. 	Shopping exhausted me today.	"To vary, use drained green peppercorns in brine."
"Here he was, in total control.  "	"Here he was, in control."	Total elimination of one ingredient is irrelevant.
Shower her with compliments.  	Give her a lot of compliments.	He rushed inside to shower her with cold water.
Life is a hospital where we fight to cure ourselves.   	Life is a place where we fight to cure ourselves.	"More than a hospital, it looked like a resort."
Let's be best friends in perpetuity.      	Let's be best friends for the whole of our lives.	The community does not hold land in perpetuity.
I'm burning of envy.        	I'm very envious.	Keep the candle burning.
The tourists will soak up any information you give them. 	The tourists will take in any information you give them.	The towel will soak up any remaining liquid.
Making drastic choice is necessary for an adventurous life.   	Making drastic choice is useful for an adventurous life.	Gravity is necessary for life as we know it.
Professors read a boatload of essays.     	Professors read a lot of essays.	The girls met on a boatload of refugees.
"He that drinks beer, only thinks beer.   "	"He that drinks beer, often thinks of beer."	He only thinks of philosphy as an esoteric discipline.
"If our plan goes up in smoke, I leave the group. "	"If our plan fails, I leave the group."	Tracey's kitchen goes up in smoke.
She can have any boy that she wants.     	She will have no shortage of boyfriends.	I don't know any boy of that name.
Anna's cooking is a force of nature.   	Anna's cooking is good.	We can contrast gravitation with a force of nature like electromagnetism.
They cooked a turkey the size of a cow.  	They cooked a big turkey.	The baby elephant was already the size of a cow.
It is enough to fright you out of your seven senses.   	It is enough to frighten you.	There are seven senses in which the term has been used by legislatures.
I'm sold!  	I'm convinced!	Many brands are sold commercially for far less.
"My dog is so ugly, we had to pay the fleas to live on him.  "	My dog is really ugly.	
It's unfair how the media is martyrizing the ten year old boy.  	It is unfair how the media is mistreating the ten year old boy.	"On the emperor's order, the soldiers began martyrizing the Christians."
There are no words to describe my admiration.  	I can find not many words to describe my admiration.	She found no words to describe her admiration.
His ambitious hunger moves him to a pantagruelic attempt.   	His ambitious hunger moves him to a very large attempt.	He likes the pantagruelic world described by Rabelais.
"You are a vision of loveliness, darling!  "	"You are very cute, darling!"	Our vision of the effects of the crisis has changed.
That was the easiest question in the world.  	That was an easy question.	
"When sorrows come, they come not single but in battalions.   "	"When sorrows come, they come not single but many at a time."	Collective training of the battalion is conducted here.
April is the cruelest month.    	April is the worst month.	The cruelest judgment I received is that I was a liar.
I've found my Atlantis not far from home.   	I've found the place I want to be not far from home.	Legendary Atlantis still excites the minds of researchers.
"His classmates laughed at him, saying he had a pea-sized brain.  "	His classmates laughed at him saying he had a very little brain.	I saw a pea sized circular mass on my left arm.
Shami and Peter are deliriously happy together.     	Shami and Peter are very happy together.	"Afflicted by an outbreak of fever, they were speaking deliriously."
The task was of too herculean a nature to be accomplished within four years. 	The task was of too difficult a nature to be accomplished within four years.	Herculean battles took place daily.
I could live on these broccoli and there is no need for anymore to say.    	I could live on these broccoli.	I could live on very limited means.
Johnny was scared of his own shadow.  	Johnny was fearful.	The dog was scared of his own shadow.
Her eyes were gray and sharp like the points of two picks.  	Her eyes were very gray and sharp.	Two bars of the gate are sharp like the points of two picks.
Cry me a river.  	Cry a lot.	Last year my granpa went kayaking in a river.
"You can see what she's thinking, like she's almost transparent.  "	"You can see what she's thinking, she's easy to understand."	Layers of the retina are almost transparent.
What kind of sorcery is this?  	What is this incomprehensible thing?	Bad fortune was often attributed to sorcery.
Love is blind.     	Love makes you ignore bad things.	I think her friend is blind.
Precisely nothing could go wrong with his plan.    	Almost nothing could go wrong with his plan.	"I caught precisely nothing, not even a pea."
"And he was rich - yes, richer than a king.   "	"And he was rich - yes, very rich."	The Queen is more limited in her powers than a king would be.
I must impose chains upon myself.     	I must impose restrictions upon myself.	I sobbed as they placed the chains upon my back
An army of artists was crowding the room.   	A large group of artists was crowding the room.	A small army of security agents converged on the house.
I'm sure you are another Mother Teresa.    	I'm sure you are a good person.	Another Mother Theresa cannot exist.
Grandpa is older than dirt.    	Grandpa is very old.	Grandpa found more than dirt in the attic.
She shows no emotions: she has become an iceberg of a woman.  	She shows no emotions: she has become a cold woman.	Such examples represent the tip of an iceberg.
"The coffee was really good, but it costed me my monthly money.   "	"The coffee was really good, but it cost me a lot of money."	I started saving my monthly money.
Her boyfriend would obey her commands like a tame pet.   	Her boyfriend would obey her commands without hesitation.	The animal in question is a tame pet.
It's an indefensible sin to steal a pin.      	It's wrong to steal a pin.	Mixing alcohol and firearms was considered an indefensible sin in all of my safety courses.
They are unlike any other olives out there.    	The olives are better than other olives out there.	It is a town unlike any other I have known before.
He was born with crystal bones.      	He was born with fragile bones.	Crystal jewels are teardrop shaped.
"It's so hot, it feels like I'm in a sauna.    "	It's so hot.	She declared that the sauna was suffocating.
Franch's is more than the best.      	Franch's is the best.	"Ice-cream here is delicious, more than the best in our country."
"She smiled at me, I almost fell out of my chair.   "	She smiled at me and I was surprised.	"I was trying to get those waffles, and I fell out of my chair."
This new brand is unmistakable.        	This new brand is good.	Being aware of our thoughts is the unmistakable sign that we exist.
"I can't let go now, I'm possessed.     "	"I can't let go now, I'm deeply engrossed in this."	Barnes possessed excellent paintings by Cézanne.
The news has been blown out of all proportion.    	The news has been exaggerated.	The ballon has been blown out of proportion and has exploded.
I sold my soul to the Devil to get you through college.   	I worked hard to get you through college.	
Her strength awoke in poets a love that is eternal.   	Her strength awoke in poets an abiding love.	They supported the view that laws of nature are eternal.
This kind of anger rages like a sea in a storm.  	This kind of anger rages violently.	Fishermen pledged to combat the waves of the sea in a storm.
"Precious, self-contained, and solitary as an oyster.   "	"Precious, self-contained, and solitary."	This egg is slippery as an oyster.
He appeared like a descended god.      	He appeared graceful.	Jesus sits among men as a descended god.
"That said, I'm on the precipice of doom.    "	"That said, I'm feeling close to defeated."	The first attack brought doom to the colony.
The best education systems don't necessarily dole out piles of homework to students. 	The best education systems don't necessarily dole out a lot of homework to students.	They collected flat piles of twigs in the wood.
My little sister gravitates towards me. She's my satellite. 	My little sister moves around me. She's my follower.	Every satellite of Saturn gravitates towards the others.
"There are no leftovers, he's a dustbin!    "	"There are no leftovers, he eats a lot!"	He's sitting on a dustbin.
This room is an oven.  	This room is very hot.	Bake the bread in a preheated oven.
Why do we have four thousand forks and no spoons?  	Why do we have so many forks and no spoons?	A total sample of four thousand subjects was obtained.
It was a gust of fragrances.      	It was a sudden rush of fragrances.	I was buffeted by a gust of wind.
This is a tough situation. You're having a gorilla on top of you.  	This is a tough situation. You're having a lot of pressure.	Having a gorilla in the picture would ruin it.
I want to get you out of my head.  	I want to stop thinking about you.	Useful ideas come out of my head today.
There's dust everywhere.    	There's dust all around.	The horrors must be stopped everywhere.
He is so vicious that there should be a circle in Dante's Inferno specifically for him.  	He is so vicious that there should be a harsh punishment specifically for him.	A circle in Dante's Inferno is for the lustful.
"John was called ""the elephant of the class"" for his clumsiness.    "	John is very clumsy.	The elephant of the class is a book for children.
Looking for a featherweight tripod.   	Looking for a lightweight tripod.	A featherweight insect was flying about his head.
"With each of her screams, the world came apart.   "	"With each of her screams, the world felt very sorrowful."	She explained how the Arab world came apart.
I have a headache the size of Texas.  	I have a severe headache.	The diameter of the largest asteroid is about the size of Texas.
The true meaning of decadence can be found in this meal!  	This meal is decadent!	Ignorance of the true meaning of a word leads to misunderstanding.
Every one of her drawings is a rapture for the eyes.    	Each of his drawings is pleasing to the eyes.	The monk said he was lost in a spiritual rapture.
Have you seen the feverish activity in grandma's kitchen?     	Have you seen the very busy activity in grandma's kitchen?	To start with you may feel slightly feverish.
Hope deferred makes the heart sick.        	Hope deferred makes one sad.	Too much wine makes the heart sick.
He is more aged than the hills.        	He is very old.	This place is more remote the hills I had known.
There are ketchup die hard fans out there.      	There are big ketchup fans out there.	Cockroaches are die hard creatures.
If I tried to carry all that cargo in my head it would make me stoop-shouldered.  	If I tried to carry all that cargo in my head it would make me quite tired.	I may become stoop- shouldered and develop back problems.
"I don't lie, I'm a slave to the truth.    "	"I do not lie, I'm a teller of the truth."	The boy was given as a slave to the emperor.
You're too beautiful.      	You're beautiful.	Our wood was too big to fit the little hole.
My dad'll hit the roof when he finds out that I wrecked his car.  	My dad'll be very angry when he finds out that I wrecked his car.	The golf ball hit the roof of the house.
A player who can stop our team from winning the championship does not exist.  	A player who can stop our team from winning the championship would be hard to find.	The account does not exist in the registry.
He has an encyclopedic knowledge of the impressionists.    	He has a very impressive knowledge about the impressionists.	I started helping out with an encyclopedic dictionary.
The king can do no wrong.  	The king is above the law.	Babies can do no wrong.
Chris won't drive her home because she lives on the other side of the universe.   	Chris won't drive her home because she lives very far.	Chris wonders if there is civilization on the other side of the Universe.
"Your father is a legend, no one worked hard for the community like he used to do.  "	"Your father is well known, no one worked hard for the community like he used to do."	Muhammad Ali became a legend.
She enters my brain and cleans the mess.  	She orders my ideas.	Drug-infused blood entered my brain.
My heart burns for you.    	My heart shakes for you.	A flame burns a candle.
This croissant made my day.  	This croissant improved my day.	The news made my day happy.
"Once I get her tuned up, this old car will go like greased lightning.   "	"Once I get her tuned up, this old car will go very fast."	Greased lightning is a power fist variant with an hydraulic shock.
Most of the businesses here are already skating on thin ice because of the economy.  	Most of the businesses here are already facing financial hardships because of the economy.	"When skating on thin ice, move fast."
You're an infant dad.    	You're behaving childishly dad.	The infant can now understand English.
I can make the best pesto in the world.  	I can make a delicious pesto.	Kasparov proved the best chess player in the world several times.
Bittersweet nectar flows in measureless abundance.   	Bittersweet nectar flows in great abundance.	Parents' love is measureless.
Religion is the opiate of masse. 	Religion is the control of the people.	Opiates are prescribed to relieve acute pain.
"No one knows where Gatsby came from, but he was surely swimming in money.  "	"No one knows where Gatsby came from, but he surely had a lot of money."	A duck was swimming alone in the river.
"Julia is shy but when it comes to fashion business, she's a war machine.  "	"Julia is shy but when it comes to fashion business, she's a hard worker."	Catapults are an old war machine.
The story hit the web and inflamed the chat sites.   	The story hit the web and created excitement on the chat sites.	"By the time I looked at the fire, it had inflamed the trees."
"By the time Alf finishes that story, his beard will be three inches longer.   "	"By the time And finishes his story, a lot of time will have passed."	"In a few months, his beard will be three inches longer."
Punctuality is the soul of business.   	Punctuality is a crucial aspect of business.	Alchemists considered volatile oils to be the soul of a plant.
"At no point in my life I'll say ""never"".  "	"I avoid saying ""never"" at any point in my life."	Never share a needle or syringe if you're injecting drugs.
She gave a deadly glare at the people making fun of her.   	She gave a mean glare at the people making fun of her.	The invasion was deadly.
It's hot enough to fry an egg on the sidewalk.  	It's very hot.	Kids should stop sliding on the sidewalk.
He's leaping up and on the bed with such force he'll be catapulted through the roof.  	He's leaping up and on the bed too vigorously.	The stone was catapulted through the roof of the castle.
Needs must when the devil drives.   	Needs must when you are being desperate.	The devil drives to consider new opportunities.
Get a deep knowledge of that world which is man.   	Get a deep knowledge of that complex being which is man.	Regimes around the world were using new methods of repression.
The air I breathe in a room empty of you is unhealthy.  	I can't stand being away from you.	Clinical obesity is unhealthy.
I've drowned myself trying to help you.     	I've sacrificed a lot to help you.	I almost drowned myself in the lake.
She spilled the wine on the table...this is a catastrophe! 	She spilled the wine on the table...this is unfortunate!	Survivors informed us about the catastrophe.
"I mean, you have the kind of talent that I would chop off my head to have.   "	"I mean, you have the kind of talent that I admire."	The criminal had previously tried to chop off my hand.
They were gone in no time.     	They were gone quickly.	The operation results in no time limits being applicable.
He only has garbage in his brain.  	He only has bad thoughts in his brain.	Garbage littered the streets.
There was a magical atmosphere.     	There was a pleasant atmosphere.	There are magical creatures in the tale.
The new shampoo is ten times better than the other.   	The new shampoo is much better than the other.	The accuracy of the new algorithm is ten times better than the old.
"When spectre-like, I enter alone upon the stubble field. "	"When pale and silent, I enter alone upon the stubble field."	Spectre-like shadows were cast through the window.
"Sorry, I forgot my head at home.     "	"Sorry, I'm unfocused."	He caressed my head.
"I've been reading ""The little prince"" since I was knee-high to a grasshopper.  "	"I've been reading ""The little prince"" since I was a kid."	The grass is slowly growing. Now it is probably knee-high to a grasshopper.
"Nate discovered the reason why she's still single, despite a legion of suitors.  "	"Nate discovered the reason why she's still single, despite many suitors."	A legion of policemen was present.
His version of the facts is infinitely more convincing.    	His version of the facts is much more convincing.	The set of even numbers is an infinitely large.
My whole sense of being had been shattered by an emotional earthquake.   	My whole sense of being had been shattered by an emotional shock.	An earthquake destroyed buildings.
There's no index and the story isn't linear: this book is illegible.   	There's no index and the story isn't linear: this book is poorly written.	The signature was so faded that it was illegible.
The most fun you'll ever have.      	You'll have a great fun.	This Lamborghini is the most expensive car you'll ever have.
One picture is worth ten thousand words.    	One picture is sufficient to convey so much!	The first day he wrote ten thousand words.
I'm scared the spider will anaesthetize my legs and start chomping them.  	I'm scared the spider will anaesthetize my legs and start biting them.	I open the marshmallow bag and start chomping them down.
"March comes in like a lion, and goes out like a lamb.       "	March comes in fiercely and goes out meekly.	"This tiger is big like a lion, and white as a lamb."
What she touches turns to gold.     	What she touches becomes of value or blessed.	"At this point, the potion of the alchemist turns to gold."
John's new idea is a theoretical diamond. 	John's new idea is very valuable.	He has a tattoo of a diamond on the first finger.
Not a word of it made sense.     	Not much of it made sense.	Not a word was spoken in those final seconds.
I would eat pizza at every moment.   	I would eat pizza often.	The nation seems to be threatened by civil war at every moment.
The chance of your friend seeing us is astronomically small.   	The chance of your friend seeing us is very small.	Black holes are particularly interesting astronomically.
After lunch I was full to overflowing.       	After lunch I was very full.	Show him the folder overflowing with letters.
"At that point, the presidency was fatally wounded.    "	"At that point, the presidency was hard to recover."	The pilot was fatally wounded.
She has a magic touch I mean she fixes my problems.    	She is very helpful I mean she fixes my problems.	"By the magic touch of his wand, the different castes of men shall be sorted."
This is honestly the best seasoning salt in all the land.   	This is very nice seasoning salt.	Years of abundance was coming in all the land of Egypt.
The crowd was enchanted by the performance.       	The crowd was delighted by the performance.	A wicked witch enchanted the princess.
You're a grumpy bear.         	You're grumpy.	His son would like to adopt a bear.
He lost his shirt in the stock market.      	He lost all his money in the stock market.	He lost his shirt in the crowd.
Manners make the man.         	Manners are an important aspect of being a man.	Time and experience will make a man of him.
Football is all he cares about.       	Football is the thing he cares about the most.	All he wants to read is comics.
"I resign from humanity. I no longer want to be, nor can still be, a man. "	"I can't stand being a human. I no longer want to be, nor can still be, a man."	I resign from my job.
Living under my parents' control is a damnation!   	Living under my parents' control is awful!	The text is about the damnation of those who ignore morality.
Kilometric line at the cashier.   	A long line at the cashier.	Archaeologists uncovered a kilometric line of constructions.
My nephew is moving heaven and earth.  	My nephew is making huge efforts.	Heaven and earth are two opposing spheres.
She thinks avocado tastes like compost heaps.  	She thinks avocado tastes terrible.	The room where the old man lived smelled like compost heap.
The pain was unendurable.      	The pain was excruciating.	"I mean, kids are almost unendurable!"
Satisfaction floods into my veins.     	Satisfaction pleases me.	I received the transfusion. My father's blood now floods into my veins.
The level of discombobulation in the realm of global politics is simply colossal. 	The level of discombobulation in the realm of global politics is very high.	The stone temple was simply colossal.
John has a divine smile.   	John has a nice smile.	The nation is to represent the divine order established by God.
Sky is falling.      	Disaster is imminent.	The kite is falling.
My ex boyfriend! Treacherous snake!  	My ex boyfriend! Treacherous person!	A treacherous snake was slithering through my legs.
Sacrificed my french fries to his monstrous appetite.     	Sacrificed my french fries to his hunger.	Monstrous beings are frequent in myths.
I'm speechless!    	I am without many words.	Even speechless animals show anger.
When the girl lost her puppy she cried an ocean of tears.  	When the girl lost her puppy she cried many tears.	Here you get the real feel of the ocean.
My spirit is crying for leaving.   	I want to leave badly.	I was crying for leaving my home.
"I can't breathe, there are mountains of dust here.  "	"I can't breathe, there is a lot of dust here."	There are mountains nearby.
That child is getting into a whole world of trouble.   	That child is getting into a lot of trouble.	Alice followed the rabbit and reached a whole world of different creatures.
The eye of a master does more work than both his hands.   	The eye of a master is expert.	Anna does more work than both of you
In that library they have forests of books.      	In that library they have a lot of books.	It is in his interest to chop down our forests.
"Love, love, love these!    "	Love these very much!	I love you my dear.
He thinks that the affectual bonds prevalent in the older world has been pulverized by modernity. 	He thinks that the affectual bonds prevalent in the older world has been lessened by modernity.	He threw the pulverized contents into the air.
Knowledge without conscience is but the ruin of the soul.       	Knowledge without conscience would have a deleterious effect on your soul.	Faulty politics lead to the ruin of the country.
Your shoes can buy a bungalow.   	Your shoes are expensive.	You can buy a Bungalow in the historic district.
"When I was young, my family was my universe.   "	"When I was young, my family was my role model."	A harmonious rapport exists between mankind and the universe.
Illusion is the ultimate weapon.    	Illusion is a powerful tool.	The Tsar's ultimate weapon was his army.
The little girl was drowning in her tears.  	The little girl was crying a lot.	The little girl was drowning in the lake.
I'm living on bread and water.     	I'm living on very little.	Poor people here are living on bread and water.
He groaned as if he was being crushed.   	He groaned as if he was hurt.	My body was being crushed by a truck.
He put loads and loads of cream on his cake.  	He put lots of cream on his cake.	You see caravans delivering loads of water.
Newspapers only contain garbage and dirt.  	Newspapers only contain bad information.	Garbage and dirt accumulate in residential areas.
He is just building castles in the air if he does not take any action.   	He is just being fanciful if he does not take any action.	Building castles on the top of hills makes them safe.
I apologized like a madman.     	I apologized profusely.	The murderer was clearly a madman.
My powers are beyond your mortal imagination.   	My powers are difficult to understand.	My house is beyond the wall.
"I now embrace ""Hollywood"" endings, but there was a time when I genuflected to kill-offs. "	"I now embrace ""Hollywood"" endings, but there was a time when I liked kill-offs."	I genuflected to the tabernacle and left the church.
The minister is going to wreck the country with his budget cuts.    	The minister is going to harm the country with his budget cuts.	They're going to wreck the machines.
"He had a great reputation as an orator, and is characterized by Ennius as ""the quintessence of persuasiveness"".    "	"He had a great reputation as an orator, and is characterized by Ennius as the example of persuasiveness."	Abnegation is often regarded as the quintessence of love.
I have a horrible face today.   	My face is definitely not at my best today.	Gargoyles have a horrible face.
This is how to be irresistible to women.   	This is how to be attractive to women.	Social change occurs when irresistible forces come from outside.
The secretary was pounding the keyboard trying to finish the report.   	The secretary was hitting the keyboard trying to finish the report.	She was pounding the hammer against the iron bars.
I simply fell in love with these chips and refused to share them with my friends.   	I liked these chips and refused to share them with my friends.	I soon fell in love with his friend.
It's all top secret and now everybody's walking on eggshells.  	It's all top secret and now everybody's trying to be careful.	"When you walked on the cracky floor, it sounded like you were walking on eggshells."
They witnessed a paradise revealed on this very same earth.    	They witnessed a beautiful place on this very same earth.	He thought a place awaited him in paradise.
It is the last straw that breaks the camel's back.     	The last thing makes everything worse.	A cargo of four hundred kilos breaks the camel's back.
I am trying to solve a million issues these days.    	I am trying to solve many issues these days.	They implemented a system that can solve a million issues.
Their latest album blasted its way up the charts.    	Their latest album quickly moved up the charts.	They had blasted their way with dynamite.
It's raining cats and dogs.          	It's raining hard.	Cats and dogs are not allowed in the sandpit.
Saying the entire campaign is ill-informed because you disagree with one point is throwing out the baby with the bathwater. 	Saying the entire campaign is ill-informed because you disagree with one point is losing valuable things to get rid of what is not wanted.	The mother had the intention of throwing the baby out of the window.
Everybody's eyes are as large as saucers.        	Everybody's eyes are very big.	"Many mushrooms had sprouted, which were as large as saucers."
Dad went ballistic when he saw the dent in his car.    	Dad became very angry when he saw the dent in his car.	Ballistic missile defence programmes were reinforced.
Granma was a harsh school girl who made kids behave. She was a real paint-remover.   	Granma was a harsh school girl who made kids behave. She was a real strict person.	You should clean the wall with a real paint-remover.
The lesson was taking forever.       	The lesson was taking a long time.	I won't be a tourist forever.
The cream you bought will last for centuries.    	The cream you bought will last for a long time.	I am studying the literature of the last three centuries.
"As the exam date approaches, she becomes a sort of hermit, spending all her time in her room.    "	"As the exam date approaches, she becomes a sort of hermit, spending most of her time in her room."	"This summer, she has been spending all her time in Europe."
I've had to reinvent myself from the ruins of my choices.   	I've had to make a new beginning from the bad outcome of my choices.	The house is built from the ruins of the old stables.
"Apparently, my fingers are made of butter tonight.   "	"Apparently, my fingers are slippery tonight."	Something smothered in a sauce made of butter.
It is intolerable to live without my phone.    	It is uncomfortable to live without my phone.	If the relationship becomes intolerable
I am exceedingly sorry.         	I am really sorry.	The door was exceedingly big for that wall.
Look at her furious fingers articulating words as she writes the report.  	Look at her fast moving fingers articulating words as she writes her report.	The emperor was furious with the defeat.
The meeting was a nightmare.   	The meeting was terrible.	He sleeps soundly without a nightmare.
My sister is a vortex of intelligence in space.  	My sister is intelligent.	The generator can create a vortex of air in the space.
"I'm so drunk, the world spinning around.   "	"I'm so drunk, I feel dizzy."	The lesson was about the world spinning around its axis.
You are slower than a snail.     	You are very slow.	The big wheel moved slower than a snail.
"Your interpretation goes too far, it's a Pindaric flight.  "	"Your interpretation goes too far, it lacks of unity."	That was the end of the pindaric flight.
My parents would have about two hemorrhages apiece if I told anything personal about them.   	My parents would have a fit if I told anything personal about them.	Patients were diagnosed with intracranial hemorrhages.
We've been here countless times.   	We've been here many times.	Cells divide countless times during a lifetime.
He has the charisma of a traffic cone.   	He has little charisma.	He wears a hat in the shape of a traffic cone.
You guys are both less than zero help.   	You guys are of no help.	The temperature is less than zero degrees.
"But you are mute, mute as a fish.   "	"But you are mute, quiet."	"Of course he was mute as a fish, he was dead."
"Getting older helped me clarify the events of my childhood, without exceptions.   "	Getting older helped me clarify some childhood memories.	The law applies without exceptions.
I am crushed by a corrupt and criminal justice system. 	I am being harmed by a criminal and corrupt justice system.	They remained terrified of being crushed by the mob.
I am in the middle of an emotional tornado.    	I am in the middle of emotional turmoil.	He was in the middle of a tornado on the highway.
The act of love strongly resembles torture.   	The act of love strongly resembles severe pain.	Sometimes surgery resembles torture.
A hundred thousand apologies would not be enough.   	Many apologies would not be enough.	A hundred thousand people were killed here.
His feet are colder than the arctic.    	His feet are very cold.	The Antarctic is colder than the Arctic.
"Well, you've got an empty head.      "	"Well, you are unable to understand some things."	Brain areas were drawn on the image of an empty head.
Sometimes asking feels like firewalking.   	Sometimes asking feels very dangerous.	The entertainment at the resort was firewalking.
Johnny worshipped the ground Dallas walked on.   	Johnny was very fond of the ground Dallas walked on.	Johnny worshipped the statue of the reigning ruler.
"You unreasonable, pompous, blustering, old windbag!  "	"You unreasonable, pompous, blustering, old bigmouth!"	"When I blew into the windbag, it created an area of lower pressure."
It's been a lifetime since I found someone nice to me.  	It's been a long time since I found someone nice to me.	You will face a lifetime ban.
"Here I sit, sunk in my thoughts.       "	"Here I sit, focused on my thoughts."	Lots of vessels sunk in the storm.
I'd rather French kiss a rattlesnake than miss a gym period.  	I'd rather pay dearly than miss a gym period.	Do not try to French kiss a rattlesnake.
I couldn't believe how large the size of the potatoes was.  	I was impressed with how large the size of the potatoes was.	I couldn't believe their stories.
You could have knocked me over with a feather.     	You could have easily knocked me over.	Someone was tickling me with a feather.
I'm dissolving into a puddle.       	I'm over-heated.	My pudding was slowly dissolving into a puddle of watery gravy.
"Their headmaster was omnipresent, as he seemed to be all around the school all the time. "	Their headmaster seemed to be all around the school all the time.	A part of Europe is different for the omnipresent nature of its pollution.
My aim is as certain as the rising sun.  	My aim is very certain.	"Outside the weather is beautiful, blue sky and rising sun."
My granpa snores louder than a faulty engine.   	My grandpa snores very loudly.	It was a case of mea culpa rather than a faulty machine.
I could smell his hellish breath.    	I could smell his horrible breath.	Hellish flames smothered the angelic figures in the painting.
Your pride is a mortal sin.    	Your pride is bad.	The Bible describes sins as mortal.
My admiration for him is deep as the ocean.  	My admiration for him is profound.	His eyes are as blue as the ocean.
"Well, dear, her hostess would reply with a frigid smile.  "	"Well, dear, her hostess would reply with a cold smile."	"In this frigid season, crowds lined up to buy milk."
Boys will gladly go to war for you.        	Boys will happily do accept challenges for you.	Militias would go to war again.
"Me, the wife of that boorish, brainless man.    "	"Me, the wife of that boorish, unwise man."	Search engines are brainless entities.
"As a matter of fact, I'm all steamed up about it.   "	"As a matter of fact, I'm all enthusiastic about it."	The window of the cafe was steamed up.
Tastiest roast of all times.         	Tastiest roast I've had.	British Empire has been the largest of all times.
I mean this was Toyland in the midst of the depression.   	I mean this was something fun in the midst of the depression.	"In his dreams, Toyland was a place where all the toys lived together."
You can search in heaven and earth but you'll not find me.  	You can search everywhere but you'll not find me.	The described events in heaven and earth are related in a symbolic sense.
ABU is hypnotically drawn to it.      	ABU is drawn to it.	The victim is hypnotically put to sleep.
People bend to his will.      	People tend to do what he wants.	I had to bend to look under a low archway.
She can make me follow her with one word from her lips.    	She can make me follow her easily.	The queen can put anyone to death with one word from her lips.
That girl is a marionette who is manipulated by what she sees on TV.  	That girl is manipulated by what she sees on TV.	"I am fascinated by the construction, whether it is a marionette or a doll."
He changed his mind in the blink of an eye.     	He changed his mind very fast.	Optimal solutions are achieved by neural networks in the blink of an eye.
"You won't beat this taste, it is insurmountable.    "	"You won't beat this taste, it is amazing."	Intact skin is an insurmountable barrier to the virus.
Its golden roofs are brighter than the sun itself.  	Its golden roofs are very bright.	There exists a system generating light brighter than the sun.
I would recognize my sisters a day's march away.  	I would recognize my sisters from a long distance.	The next settlement is a day's march away.
"He is so majestic, when he wears a yellow shirt people yell: ""Hey taxi!""   "	He is so majestic.	"In New York, people yell ""Hey taxi!"" and they soon get a ride."
You're charged with high treason for telling mom I didn't have lunch!    	You're in a lot of troubles for telling mum I didn't have lunch!	The murderer would be charged with high treason.
She's a difficult person to work with because she has no filters.   	She's a difficult person to work with because she is very direct when conversing.	My camera has no filters.
The study of beauty is a duel in which the artist cries out in terror.      	The study of beauty is a duel in which the artist suffers.	"Sitting on her knees, the artis cries out in terror."
You always concentrate my whole senses.    	You have my attention.	My whole senses were on high alert.
No one knows her. She's mysterious as the dark side of the moon.  	No one knows her. She's very mysterious.	The dark side of the Moon is covered in craters.
Another idea burst into flames.    	Another idea gone wasted.	The bomb burst into flames.
"Stop using onion in this recipe, you dregs of mankind.   "	Stop using onion in this recipe you terrible people.	This judge does not tolerate robbers and other dregs of mankind.
Each of these girls is a perfect porcelain doll.   	Each of these girls is delicate and lovely.	A perfect porcelain doll has no cracks.
They sell books by every author who has ever set pen to paper.  	They sell books by a great number of authors.	Every poet who has ever set pen to paper knows how to write.
The meal I prepared contains a million calories!   	The meal I prepared is rich in calories!	I can eat about a million calories a year and maintain my weight.
Scientists are light years away from understanding the human brain.    	Scientists are far away from understanding the human brain.	Hydrogen shows the cloud to be light years away from the earth.
To infinity and beyond Buzz.     	Let's go as far as we can Buzz.	
John invariably knows the right thing to say.    	John usually knows the right thing to say.	Her associates were invariably businessmen.
A sea of people surrounded the stage.      	A large number of people surrounded the stage.	The sea soughed on the shore.
Such an unscrupulous person...he's a pig.   	Such an unscrupulous person...he's disrespectful.	"Mr. Babe is my pet, he's a pig from Guinea."
Look how grown up!Only yesterday you were on your tricycle.   	Look how grown up! It wasn't that long ago that you were on your tricycle.	"Only yesterday, I ordered the registration of children."
Sleeping on this pillow is sleeping on a cloud.     	Sleeping on this pillow is sleeping on something very soft.	Flying over a cloud is not risky.
For a few dollars they would start a war.      	For a few dollars they would fight.	They would start a war to take the counties.
The big bells as loud as the thunder.        	The big bells very loud.	All those weapons emitted a blast as loud as the thunder.
That child is the devil incarnate.       	That child is a trouble maker.	The snake in the Genesis was the devil incarnate.
They are a stingy family. There are like trillions of savings under one roof!  	They are a stingy family. There are a lot of savings under one roof!	There are like trillions of possible combinations of such digits.
"When you open this map, you own the city.  "	"When you open the map, you know a lot about the city."	Freehold means you own the land.
"I tried to explain myself, but she is a waxy-eared person.   "	"I tried to explain myself, but she doesn't want to listen."	Waxy-eared persons should go to the otolaryngologist.
I write my diary when I feel crushed by the weight of life.  	I write my diary when I feel under pressure.	The bin is crushed by the weight of the roof.
My sister uses so much makeup; she broke a chisel trying to get it off last night!   	My sister uses so much makeup; she had difficulty trying to get it off last night!	My sister broke a chisel trying to carve wood.
"My aunt is so fat that when she walks by the TV, I miss three shows.      "	"My aunt is so fat that when she walks by the TV, I can't see the screen."	"If she comes for dinner, I'll miss three shows."
The old man is a dinosaur.   	The old man is very old.	A paleontologist was holding the bone of a dinosaur.
"My best friend is so forgetful, I sometimes have to remind her what her name is. "	"My best friend is so forgetful, I have to remind her of many things."	I forgot what her name is.
Your kindness turns me upside down.    	Your kindness astounds me.	I like it when a roller coaster turns me upside down.
Cowards die many times before their death.  	Cowards do not live their lives to the fullest.	Your character die many times in the game.
He lives far away - on the other side of the Galaxy.   	He lives far away - a large distance from here.	Astronomers have found five Cepheids on the other side of the galaxy.
Peter's essay constituted yet another infinite monologue.   	Peter's essay constituted yet another long monologue.	Scientists study the infinite variety of combinations of neurones.
"During the debate, the president ate reporters and photographers.  "	"During the debate, the president treated reporters and photographers badly."	The president ate pasta for dinner.
"You must come out of bed, I've walked a thousand miles to spend some time with you.  "	"You must come out of bed, I've walked a long way to spend some time with you."	This street is three thousand miles long.
"Right now, with the sword hanging over my head, I don't have any kind of financial support.   "	"Right now, in this risky situation, I don't have any kind of financial support."	"There's a sward hanging over my head, there on the wall."
"She's bothered by dust, so she's unceasingly cleaning the house.  "	"She's bothered by dust, so she's frequently cleaning the house."	The universe is unceasingly moving toward more disorder.
Let me see an abyss of knowledge.  	Let me see a vast amount of knowledge.	Invite a seafarer and explore the abyss of the ocean together.
I'll persevere till the stars drop from the sky. 	I'll persevere for a long time.	You could see falling stars that drop from the top of the picture.
There lived a man as big as a barge.  	There lived a large man.	The dinosaur was as big as a barge.
I've got a thorn in my heart.    	I've got sorrow in my heart.	I have a thorn stuck in my finger.
Perfection assassinates creativity.  	Perfection is not good for creativity.	The wrestler was asked to assassinate his opponent.
I don't think a herd of elephants would be as noisy as this class is today!  	This class is very noisy today!	A herd of elephants was drinking from a lake.
He's the worst man on earth.   	He is a bad man.	This city is the worst on earth with respect to air pollution levels.
She's like vomiting all her feelings out with hate.  	She's expressing all her feelings out loud with hate.	Vomiting accompany the first months of pregnancy.
Reading dog food labels is often like reading hieroglyphics.     	Reading dog food labels is hard to understand.	Researchers have succeeded in reading Egyptian hieroglyphics.
I'll be crystal clear: I don't like him.       	I'll be clear: I don't like him.	The shelves contained crystal clear glasses.
Turning your face away is a punch in the gut.      	Turning your face away is insulting.	The boxer threw a punch in the gut of his opponent.
The painter knows that looking at the beautiful landscape is an orgasmic experience.  	The painter knows that looking at the beautiful landscape is an enjoyable experience.	Low orgasmic experience has been related to childhood loss.
Too many clothes in this Indian Summer and I am suddenly in a bath of sweat.   	Too many clothes in this Indian summer and I am sweating a lot.	I sit in a bath of warm water.
The president has fought tooth and nail to be reelected.    	The president has fought really hard to be reelected.	The tooth and nail brushes were manufactured by the firm of Addis.
"I'm a burst of colors today, I'm wearing a yellow t-shirt and red trousers.  "	"I'm very colorful today, I'm wearing a yellow t-shirt and red trousers."	There is a burst of color in the messy room of the painter.
She's a dictator in our house.        	She's a ruler in our house.	The military dictator urged supporters to defeat the indecisive ones.
Molasses buckets appeared from nowhere.    	Molasses buckets appeared unexpectedly.	One view is that the big-bang that came from nowhere.
He's my favourite person in the world. The rest is drips.    	He's my favourite person in the world. The rest is not important.	When it brews there is drips of water coming out.
"You get into that University, you won't get out alive.    "	"You get into that University, you won't make it."	"Life is cruel, after all you won't get out alive!"
This discovery is like a tender newborn to young scientists.   	This discovery is very precious to young scientists.	The tender newborn is sleeping quietly.
This dirty money we're using to finance the campaign is a ticking time bomb!    	This dirty money we're using to finance the campaign is a risk!	The party continued until a ticking time bomb exploded.
"New hair, new life.   "	New hair will feel like a fresh start.	New life springs forth in the desert.
"Your plan is too risky, it's a suicide.   "	"Your plan is too risky, it's dangerous."	On every occasion there was a suicide attempt.
"I just can't seem to forget him, he contaminates my head.     "	"I just can't seem to forget him, I keep on thinking about him."	Mercury contaminates mostly fish and fishery products.
The bad sides are so overpowering that she can't see anything else.  	The bad sides are so overpowering that she finds it difficult to concentrate on anything else.	She can't see the red signal.
You have ravished me away by a power I am unable to resist.    	You have ravished me away by a power I find difficult to resist.	I am unable to be at two places at the same time.
"I'm half dead, for Christ's sake!    "	"I'm very tired, for Christ's sake!"	Zombies are half dead.
"When the last light set, it was like the whole world stopped.   "	"When the last light set, it was beautiful."	The whole world stopped producing this car.
This is one breathtaking panorama.        	This is one beautiful panorama.	I received a punch in the stomach. The pain was breathtaking.
Admit you're a Judas.        	Admit that you're a traitor.	Judas Iscariot hanged himself.
Once I would open a bag I could not stop eating.   	Once I would open the bad I would not want to stop eating.	A lack of control is felt as if one could not stop eating.
She's drinking like tomorrow doesn't exist.    	She's drinking heavily.	Tomorrow doesn't exist yet.
"If you leave me, I'll erase you.      "	"If you leave me, I'll forget about you."	Both the commands will erase the content of the file.
"And his sensibility, oh, he must be related to those machines that register earthquakes. "	"And his sensibility, oh, he must be very sensitive."	The geologist was using those machines that register earthquakes.
You are what you eat.    	What you eat affects you.	These answers are what we wanted to hear.
He only sees himself.     	He only cares about himself.	He only sees himself as a normal guy.
The sight of them kissing is so gross that it makes me want to puke.  	The sight of them kissing is so gross that it makes me feel disgusted.	"If I'll feel sick, I won't puke."
"Since you stopped partying, you're a nullity.    "	"Since you stopped partying, you're boring."	Judgments obtained by fraud on court will become a nullity.
TV is bombarding us with subliminal messages.   	TV is providing us with subliminal messages.	Militaries were bombarding the town.
The secretary was up to her eyeballs in paperwork.  	The secretary had a lot of paperwork.	The victim was splattered with blood up to her eyeballs.
"He looked at the glass, and lowered his lips to that oasis of moisture.   "	"He looked at the glass, and lowered his lips to the water."	These steam seeps provide an oasis of moisture in the desert.
It is idle to swallow the cow and choke on the tail.   	It is idle to swallow big problems and choke on small ones.	An anaconda tried to swallow the cow.
I'm not staying here one more minute!      	I'm not staying here any longer!	I'm allowed one more minute after the bell.
Junk food is the one thing they'll buy in spades.  	Junk food is the one thing they'll buy in large quantities.	Farmers used long-handled spades for digging.
"I swear, my teacher is omniscient.        "	"I swear, my teacher knows a lot."	The girl believed Santa Claus is omniscient.
"Your beard is so hairy, you look like Chewbacca.   "	Your beard is very hairy.	Chewbacca had a big furry.
Don't strain at gnats and swallow camels. There are worse problems than that around here.  	Don't make a big deal about little things. There are worse problems than that around here.	The bow can be made to strain the string to its breaking point.
"Sad to say, but she was a relentless drinker.      "	"Sad to say, but she was a constant drinker."	I came to watch the relentless forming and breaking-up of waves.
"Dresden was kind of the moon, nothing but minerals.   "	"Dresden was kind of the moon, it did not have many appeals."	Precious stones are nothing but minerals.
And with all this romantic atmosphere disaster's in the air.    	And with all this romantic atmosphere something could go wrong.	There was a climatic disaster.
The perfect pound cake recipe is worth its weight in gold.   	The perfect pound cake recipe is valuable.	A true diamond is worth its weight in gold.
My professor is a volcano of ideas.   	My professor is very creative.	Elgon is the remains of an ancient volcano.
Shuttling between conferences over the past years has been an interstellar enterprise.  	Shuttling between conferences over the past years has been an overwhelming enterprise.	The target of early interstellar missions is to find nomadic planets.
The mail was taking on Alpine proportions.   	The mail was taking on large proportions.	Urals are the remains of mountains that must have been of Alpine proportions when new.
That runner is faster than light.   	That runner is very fast.	It is possible for a particle to travel faster than light.
They will die of envy.      	They will be very envious.	People will die of cholera and other epidemics.
The gladiator beated all his opponents with his superhuman strength. 	The gladiator beated all his opponents with his great strength.	Absolute symmetry tends to be superhuman.
"Whenever I watch the movie, that scene kills me.    "	"Whenever I watch the movie, that scene strikes me."	Drinking kills me slowly.
I'm so thirsty that I would drink a river.     	I'm so thirsty that I would drink a large amount of water.	People had to drink water from a river nearby.
Her anger radiated like a nuclear explosion.    	Her anger radiated strongly.	Only one girl survived the nuclear explosion.
This confection has been around a few centuries in my house.  	This confection has been around for so long in my house.	The hillsides have been covered a few centuries ago.
Anna cried blood tears before obtaining her bachelor's degree.  	Anna worked really hard before obtaining her bachelor's degree.	Believers swear the statue was crying blood tears.
Her skin was whiter than snow.   	Her skin was very fair.	This milk is whiter than snow on the sidewalk.
He was skinny enough to jump through a keyhole.  	He was skinny enough to jump through a small hole.	I could see daylight through a keyhole.
My mother is a tyrant.    	My mother is authoritarian.	The strategy may prevent rebellion in the circumstance of some cruel tyrant.
Changing your favorite team is like breaking a blood oath.  	Changing your favorite team is like breaking a promise.	Breaking a blood oath was punished.
In my family every birthday is a national holiday.    	In my family every birthday is a big event.	The prince's marriage will be marked by a national holiday.
Inviting my mother-in-law to stay here is a recipe for disaster. 	Inviting my mother-in-law to stay here is bad idea.	Limitation on employment and property ownership were a recipe for disaster in the country.
I bet my life that you will laugh.   	I am sure that you will laugh.	I enjoy my life.
The waiting has been endless.     	The waiting has been too long.	The sources of inspiration are seemingly endless.
I almost jumped out of my skin.    	I was very surprised.	A hair just jumped out of my skin.
The house is the size of a postage stamp.  	The house is very small.	These cereals are the size of a postage stamp.
The mall is large enough to have its own zip code.   	The mall is very large.	The fight continues to bring the neighborhood its own zip code.
I'm going to explode.  	I'm going to get upset.	Pentrite can explode without a detonator.
"I'm moving, all my life's in this luggage.  "	"I'm moving, all my stuff's in this luggage."	I've lived here all my life.
This drink is a rocket in a bottle.   	This drink is very energizing.	The rocket was projected to a considerable height.
I would commit murder to have that new phone!  	I really want to have that new phone!	It is wrong to steal or to commit murder.
Her beauty eclipsed the sun.      	Her beauty is noteworthy.	The moon eclipsed the sun.
This room is a mess. It looks like it was hit by a tornado!   	This room is a mess. It looks very untidy!	Your home got hit by a tornado.
You need an elevator to look at him in the eye.     	You need a bench to look at him in the eye.	"My leg is broken, so I need an elevator to access upper floors."
"Cheryl is so moody, she's four seasons in a day.   "	"Cheryl is so moody, she has different moods in a day."	Guest expectations change through the four seasons.
"My love, you are my oxygen.         "	"My love, you are so important."	Commercial airplanes carry a huge tank of oxygen.
"When my parents enrolled me in college, they basically sentenced me to death.  "	"When my parents enrolled me in college, they basically made my life very hard."	Three judges sentenced me to death.
"This steak is so rare, I think I heard it moo.     "	"This steak is so rare, I think it is still raw."	"There was a cow nearby, and I heard it moo."
Our fight has been going on since the beginning of time.  	Our fight has been going on for a long time.	The beginning of time corresponds to a first event.
He tolerated my annoying questions. That man is a saint.  	He tolerated my annoying questions. That man is patient.	A saint is not prayed to.
They will kneel before his talent.     	They will admire his talent.	He stepped down and turned to kneel before the altar.
His laughter shakes the walls.    	His laughter is very loud.	The wind shakes the walls of the tent.
Your room is a jungle!     	Your room is messy!	"Every room is designed to convey a theme, be it a jungle or ancient Rome."
I am so tired I could sleep for a year.   	I am so tired I could sleep for a long time.	I haven't had a job for a year now.
Every flavor is dynamite.      	Every flavor is strong.	They might enquire whether the cargo was dynamite.
She is sinking in a sea of misery.   	She is miserable.	Pirates where sinking in a sea of cold water.
We all cracked up at the joke.    	We all laughed at the joke.	The eggs have cracked up.